#####################
#b#                 #
# # ######### ##### #
#   #       # #   # #
# ### ##### # #B# # #
#   # # #   # # # # #
### # # # ### # # # #
#     #   #   #E#   #
# ####### # #########
# # #   # # #   #   #
# # # #a# # # # # # #
#   # # # #   #   # #
##### # # #########2#
#     # #   #     # #
# ##### ### ##### # #
# #   # 1 #   #   # #
# # # ### ### # ### #
# # # #  A#     #   #
# # ### ######### # #
#S#          M    #L#
#####################