#####################
# #           #     #
# # ##### ### # ### #
# # # #   #   # #   #
# # # # ### ##### # #
#     # # # #     #E#
# ##### # # # # #####
# #     #     # #   #
# #A####### ##### # #
# # #     # #     # #
### # ### ### ##### #
#S#   # #     #a  # #
# # ### ######### # #
# #               # #
# ################# #
# #   #     #       #
# # # # ### # ##### #
#   #   #   # #     #
######### ### # #####
#             #     #
#####################