########
#      #
#    E #
#      #
#      #
#      #
#      #
#S     #
########