#####################
#   # #       #     #
# # # # ### ### ### #
# # # #   #       # #
# # # ### ######### #
# # #     #   #   #E#
# # ### ### ### # # #
# #   #     #   #   #
# ### ####### ##### #
#S#a#   #   #  A  # #
### ### # # ##### # #
#     # # #       # #
# # ### # ###########
# # #   # #         #
# # # ### # ####### #
# #   #       #     #
# ##### ####### ### #
# #   # #     #   # #
# # # ### ### ### # #
#   #     #       # #
#####################