#####################
#S#?    #     #E    #
# # ### #A### #####C#
# #   #   # #       #
# ### ##### ####### #
# #   #   #   #   # #
#a# ### # # ### # # #
#   #   #   #   #   #
##### # ##### #######
#     # #     #c    #
# ##### # ######### #
#   # #   #1    #   #
### # ####### # # # #
#   #         # # # #
# ### ######### # # #
#   #     #   # # # #
### ##### # # # #B# #
#b# #     # # #   # #
# # # ##### ####### #
#     #             #
#####################