#####################
#       # X #   #   #
# ##### #   ### # ###
# #     #   # # #   #
# # ###### ## # # # #
# #     #     # # # #
# ##### ##### # ### #
#   #       # #     #
# # ####### # ##### #
# # #     #   #   # #
# # # ### ##### # # #
# #   # # #     #   #
# ##### # # ####### #
# # #   # # #       #
# # # # # ### ### ###
# #   # # #     #   #
# # ### # # ####### #
# # #   #   #   #   #
# ### # ##### # # # #
#     #    S  #   # #
#####################