#####################
#             #     #
# ##### # ### # ### #
# #   # # #a  #   # #
# # # ###1# ##### # #
# # #     # #     # #
# # ####### ####### #
# # # #   #         #
### # # # ######### #
#   #   #         # #
# ### ### ######### #
#S# # #   #         #
### # # ### #########
#   # #A    #       #
### # ######### ### #
#   # #         #   #
# ### # ######### ###
#     #       # #   #
# ########### # ### #
#             #    E#
#####################