#####################
#         a #       #
# ######### # # ### #
#   #       # #   # #
# # ####### ##### # #
# # #     #       # #
### # ### ######### #
#S#     # #   #   # #
# ##### # # # # # # #
#     # #   #   # # #
#####1########### #A#
#   #     #       # #
### ##### # ####### #
#       #   #     # #
# ##### ##### ### # #
#     # #   #   # #E#
# ### # ### # # ### #
# # # #     # #   # #
# # # ####### ### # #
#   #           #   #
#####################