#####################
#   #   # X #   #   #
# # # # #   # # # # #
# #   # #   # # # # #
# ##### ## #### # # #
# #   # #   # #   # #
# ### # # ### ##### #
#   #   #           #
# # # ### ##### ### #
# # # #   #   #   # #
# # # # ### # ### # #
# # # # #   # #   # #
# # # ### ### # ### #
# # #     # #   #   #
### ####### ##### ###
#   #   #       # # #
# # # # ##### # # # #
# # # #     # #   # #
# ### ##### # ##### #
#          S#       #
#####################